xxxxxxxxx
x m w   x
x w m   x
x m w   x
x       x
x       x
xxx R xxx
x       x
xR     Rx
x       x
xxx   xxx